  XXXXXXXXXXXXXXXXXXXXXX
 X**********************X
X************************X
X************************X
X************************X
X************************X
X************************X
X************************X
X************************X
X************************X
X************************X
X************************X
X************************X
X************************X
X************************X
X************************X
X************************X
X************************X
X************************X
X************************X
X************************X
 X**********************X
  XXXXXXXXXXXXXXXXXXXXXX